xxxxxxxxxxxxxxx
xg   x        x
xxxx xx xxxx  x
x  x    xx   xx
xx  xxxx  xx  x
xxx    x x  x x
x   x         x
x xxxxxxx  xxxx
x    x        x
xxx xx xx xx  x
xx  x  x   x xx
x        x    x
x xxx x xx xxxx
x     x  x   mx
xxxxxxxxxxxxxxx
